000000000000000000000000
000000000000000000000000
000000000000000000000000
000000000000000004000000
000000001111111000000000
000040001002001000000000
000000001003001000000000
000000001111111000000000
000000000000000000000000
000000000000040000000000
000000000000000000000000
000000000000000000000000
